XXXXXXXXX--------XXXXXXX
XOOOOOOEXXXXXXX--XOOOEOX
XOOSOOOEOOOOOEXXXXOOOXXX
XOOOOOOEXXOOOOOXXOOOOX--
XXXXXXXXXXXXOEOOOEOOXX--
-----------XXXOOOXXXX----
-------------XOOXX-------
--------------XOOX-------
-------------XXXOX-------
-------------XOOOX-------
--XXXXXX-XXXXXOOOX-------
--XOOOOXXXOOOOOOEX-------
--XOTEOOOOOOEOOOOX-------
--XOOOOXXXOOOOOEOX-------
--XXXXXX-XXXXXXXXX-------