XXXXXXXXXX--------XXXXXXXX
XXOOOOOOEXXXXXXX--XOOOEOXX
XXOOSOOOEOOOOOEXXXXOOOXXXX
XXOOOOOOEXXOOOOOXXOOOOXXX-
XXXXXXXXXXXXXOEOOOEOOXXX--
------------XXXOOOXXXXX---
--------------XOOXXX-------
---------------XOOXX-------
--------------XXXOXX-------
--------------XOOOXX-------
--XXXXXXX-XXXXXOOOXX-------
--XXOOOOXXXOOOOOOEXX------
--XXOEOOOOOOOEOOOOXX------
--XXOOOOXXXOOOOOEOXX------
--XXXXXXX-XXXXXXXXXX------