XXXXXXXXX--------XXXXXXXX
XOOOOOOEXXXXXXX--XOOOEOXX
XOOSOOOEOOOOOEXXXXOOOXXXX
XOOOOOOEXXOOOOOXXOOOOXXX-
XXXXXXXXXXXXOEOOOEOOXXX--
-----------XXXOOOXXXX----
-------------XOOXXX------
--------------XOOXX------
-------------XXXOXX------
-------------XOOOXX------
--XXXXXX-XXXXXOOOXX------
--XOOOOXXXOOOOOOEXX------
--XOEOOOOOOOEOOOOXX------
--XOOOOXXXOOOOOEOXX------
--XXXXXX-XXXXXXXXXX------