XXXXXXXXXXXXXXXXXXXXXXXX
XXXXXXXXXXXXXXXXXXXXXXXX
XOOOOOOEXXXXXXXXXXOOOEOX
XOOSOOOEOOOOOEXXXXOOOXXX
XOOOOOOEXXOOOOOXXOOOOXXX
XXXXXXXXXXXXOEOOOEOOXXXX
XXXXXXXXXXXXXXOOOXXXXXXX
XXXXXXXXXXXXXXOOXXXXXXXX
XXXXXXXXXXXXXXXOOXXXXXXX
XXXXXXXXXXXXXXXXOXXXXXXX
XXXXXXXXXXXXXXOOOXXXXXXX
XXXXXXXXXXXXXXOOOXXXXXXX
XXXOOOOXXXOOOOOOEXXXXXXX
XXXOTEOOOOOOEOOOOXXXXXXX
XXXOOOOXXXOOOOOEOXXXXXXX
XXXXXXXXXXXXXXXXXXXXXXXX
XXXXXXXXXXXXXXXXXXXXXXXx