XXXXXXXXX--------XXXXXXXX
XOOOOOOOXXXXXXX--XOOOOOXX
XOOSOOOOOOOOOOXXXXOOOXXXX
XOOOOOOOXXOOOOOXXOOOOXXX-
XXXXXXXXXXXXOOOOOOOOXXX--
-----------XXXOOOXXXXX---
-------------XOOXXX-------
--------------XOOXX-------
-------------XXXOXX-------
-------------XOOOXX-------
--XXXXXX-XXXXXOOOXX-------
--XOOOOXXXOOOOOOOXX------
--XOOOOOOOOOOOOOOXX------
--XOOOOXXXOOOOOOOXX------
--XXXXXX-XXXXXXXXXX------