XXXXXXXXXXXXXXXXXXXXXXXX
XXXXXXXXXXXXXXXXXXXXXXXX
XOcccOOEXXXXXXXXXXOOOEqX
XfcScOOEOOOOOEXXXXOOOXXX
XOcccOOEXXOOOOOXXOOOOXXX
XXXXXXXXXXXXOEOOOEOOXXXX
XXXXXXXXXXXXXXOOOXXXXXXX
XXXXXXXXXXXXXXOOXXXXXXXX
XXXXXXXXXXXXXXXOOXXXXXXX
XXXXXXXXXXXXXXXXhXXXXXXX
XXXXXXXXXXXXXXOOOXXXXXXX
XXXXXXXXXXXXXXOOOXXXXXXX
XXXOOOOXXXOOOOOOEXXXXXXX
XXXOTEOOiOOOEOOOOXXXXXXX
XXXOOOOXXXOOOOOEOXXXXXXX
XXXXXXXXXXXXXXXXXXXXXXXX
XXXXXXXXXXXXXXXXXXXXXXXx