XXXXXXXXX--------XXXXXXXX
XOOOOOOOXXXXXXX--XOOOOOXX
XOOSOOOOOOOOOOXXXXOOOXXXX
XOOOOOOOXXOOOOOXXOOOOX---
XXXXXXXXXXXXOOOOOOOOXX---
-----------XXXOOOXXXX----
-------------XOOXX-------
--------------XOOX-------
-------------XXXOX-------
-------------XOOOX-------
--XXXXXX-XXXXXOOOX-------
--XOOOOXXXOOOOOOOX-------
--XOOOOOOOOOOOOOOX-------
--XOOOOXXXOOOOOOOX-------
--XXXXXX-XXXXXXXXX-------