XXXXXXXXXXXXXXXXXXXXXXXX
XXXXXXXXXXXXXXXXXXXXXXXX
XOcccDOEXXXXXXXXXXOOOEqX
XfcScROeOOOOOEXXXXOOOXXX
XOcccDOEXXOOOOOXXOOOOXXX
XXXXXXXXXXXXOEOOOEOOXXXX
XXXXXXXXXXXXXXOOOXXXXXXX
XXXXXXXXXXXXXXOOXXXXXXXX
XXXXXXXXXXXXXXXOOXXXXXXX
XXXXXXXXXXXXXXXXhXXXXXXX
XXXXXXXXXXXXXXOOOXXXXXXX
XXXXXXXXXXXXXXOOOXXXXXXX
XOOOOOOXXXOOOOOOEXXXXXXX
XTOBOOOOiOOOEOOOOXXXXXXX
XOOOOOOXXXOOOOOEOXXXXXXX
XXXXXXXXXXXXXXXXXXXXXXXX
XXXXXXXXXXXXXXXXXXXXXXXx