XXXXXXXXXX----------XXXXXXXXXX
XOOOEOOOEX--XXXXXXX-XOOOOOOOTX
XXXXOOXXXX--XOSOOXX-XXXXOOXXXX
XOOEOOEOOX--XXOOXXX-XEEEOOEEEX
XXXXOOXXXX--XOEEOXX-XXXXEEXXXX
---XOEXOOXXXXOXXOXXXXOOXOOX---
---XOOOOOOEEOOOOOOEEOOOOOOX---
---XXXXXXXXXXXXXXXXXXXXXXXX---