XXXXXXXXXXX---------XXXXXXXXXXX
XOOOEOOOEXX-XXXXXXX-XOOOOOOOTXX
XXXXOOXXXXX-XSOOOXX-XXXXOOXXXXX
XOOEOOEOOXX-XXOOXXX-XEEEOOEEEXX
XXXXOOXXXXX-XOEEOXX-XXXXEEXXXXX
---XOEXOOXXXXOXXOXXXXOOXOOXX---
---XOOOOOOEEOOOOOOEEOOOOOOXX---
---XXXXXXXXXXXXXXXXXXXXXXXXX---