XXXXXXXXXXXXXXXXXXXXXXXXXXXXXXXXXXXX
XXXXXXXXXXXXXXXXXXXXXXXXXXXXXOOOEROX
XOOOEOOOEXXXXXXXXXXXXeeOOOOOOOOBERTX
XXXXOOXXXXXXXOSOOXXXXXXXOOXXXOOOEROX
XOOEOOEOOXXXXXOOXXXXXEEEOOEEEXXXXXXX
XXXXOOXXXXXXXOEEOXXXXXXXEEXXXXXXXXXX
XXXXOEXOOXXXXOXXOXXXXOOXOOXXXXXXXXXX
XXXXOOOOOOEEOOOOOOEEOOOOOOXXXXXXXXXX
XXXXXXXXXXXXXXXXXXXXXXXXXXXXXXXXXXXX
XXXXXXXXXXXXXXXXXXXXXXXXXXXXXXXXXXXX