XXXXXXXXXXXXXXXXXXXXXXXXXXXXXX
XXXXXXXXXXXXXXXXXXXXXXXXXXXXXX
XOOOEOOOEXXXXXXXXXXXXOOOOOOOTX
XXXXOOXXXXXXXOSOOXXXXXXXOOXXXX
XOOEOOEOOXXXXXOOXXXXXEEEOOEEEX
XXXXOOXXXXXXXOEEOXXXXXXXEEXXXX
XXXXOEXOOXXXXOXXOXXXXOOXOOXXXX
XXXXOOOOOOEEOOOOOOEEOOOOOOXXXX
XXXXXXXXXXXXXXXXXXXXXXXXXXXXXX
XXXXXXXXXXXXXXXXXXXXXXXXXXXXXX