XXXXXXXXXXXXXXXXXXXXXXXXXXXXXXXXXXXX
XXXXXXXXXXXXXXXXXXXXXXXXXXXXOOOOEROX
XOOOEOOOEXXXXXXXXXXXXeeOOOOOOOBOERTX
XXXXOOXXXXXXXOSOOXXXXXXXOOXXOOOOEROX
XOOEOOEOOXXXXXOOXXXXXEEEOOXXXXXXXXXX
XXXXOOXXXXXXXOEEOXXXXXXXEEXXXXXXXXXX
XXXXOEXOOXXXXOXXOXXXXOOXOOXXXXXXXXXX
XXXXOOOOOOEEOOOOOOEEOOOOOOXXXXXXXXXX
XXXXXXXXXXXXXXXXXXXXXXXXXXXXXXXXXXXX
XXXXXXXXXXXXXXXXXXXXXXXXXXXXXXXXXXXX