XXXXXXXXXXXXXXXXXXXXXXXXXXXXXXXXXXX
XXXXXXXXXXXXXXXXXXXXXXXXXXXXXXOOOOX
XOOOEOOOEXXXXXXXXXXXXOOOOOOOOOOBOTX
XXXXOOXXXXXXXOSOOXXXXXXXOOXXXXOOOOX
XOOEOOEOOXXXXXOOXXXXXEEEOOEEEXXXXXX
XXXXOOXXXXXXXOEEOXXXXXXXEEXXXXXXXXX
XXXXOEXOOXXXXOXXOXXXXOOXOOXXXXXXXXX
XXXXOOOOOOEEOOOOOOEEOOOOOOXXXXXXXXX
XXXXXXXXXXXXXXXXXXXXXXXXXXXXXXXXXXX
XXXXXXXXXXXXXXXXXXXXXXXXXXXXXXXXXXX