XXXXXXXXXXXXXXXXXXXXXXXXXXXXXXXXXXXX
XXXXXXXXXXXXXXXXXXXXXXXXXXXXOOOOEROX
XiOOEOOOEXXXXXXXXXXXXeeOOOOOOOBhERTX
XXXXOOXXXXXXXOSOOXXXXXXXOOXXOOOOEROX
XOOEOOEOOXXXXXOOXXXXXEEEOOXXXXXXXXXX
XXXXOOXXXXXXXcEEcXXXXXXXEEXXXXXXXXXX
XXXXOEXOOXXXXcXXcXXXXOOXOOXXXXXXXXXX
XXXXOOOOOOEEOOOOOOEEOccOOOXXXXXXXXXX
XXXXXXXXXXXXXXXXXXXXXXXXXXXXXXXXXXXX
XXXXXXXXXXXXXXXXXXXXXXXXXXXXXXXXXXXX