XXXXXXXXXXXXXXXXXX
XXXXXXXXXXXXXXXXXX
XXOOOOEOOOOEOOOOXX
XXOEOOOOOSOOOOEOXX
XXOOOOOOOOOOOOOOXX
XXOEOOOOOOOOOOEOXX
XXOOOEOOEEOOEOOOXX
XXXXXXXXXXXXXXXXXX
XXXXXXXXXXXXXXXXXX
