XXXXXXXXXXXXXXXXX
XXXXXXXXXXXXXXXXX
XXeeeOOOOOOEEOEXX
XXeSOOOOOOOBOEEXX
XXeeeOOOOOOEEOEXX
XXXXXXXXXXXXXXXXX
XXXXXXXXXXXXXXXXX
