XXXXXXXXXXXXXXXXX
XXXXXXXXXXXXXXXXX
XXeeeOOOOOOEEOEXX
XXeSOOOOOOBOOEEXX
XXeeeOOOOOOEEOEXX
XXXXXXXXXXXXXXXXX
XXXXXXXXXXXXXXXXX
