XXXXXXXXXXXXXXXXX
XXXXXXXXXXXXXXXXX
XXOOOOOOOOOEOOOXX
XXOOOOOOOOOOOEOXX
XXOOSOOOOOOBOOOXX
XXOOOOOOOOOOOEOXX
XXOOOOOOOOOEOOOXX
XXXXXXXXXXXXXXXXX
XXXXXXXXXXXXXXXXX
